oooooooo
o;o;;;;o
o;;;;o;o
o;;;;o;o
o;;;;;;o
o;;;oooo
oo;;;;;o
oooooooo
